#########################                          
S     #           #     #                          
##### ##### ####### # ###                          
#   #     #         #   #                          
# ####### # ########### #                          
#       # # #     #     #                          
##### # # # # ### # #####                          
#     # # # # # # #     #                          
# ####### # # # # ##### #                          
#     #   #   #   #   # #                          
# ### # ####### ##### # ###########################
# # #   #             #       #           #       #
# # ######################### # ##### ### # ##### #
# #     #             #     #   #   #   # # #     #
# # ### # ########### # ### ##### # ##### # # ### #
#   # # #     #   #   # #         # #   #   #   # #
##### # # ### # # # ### ########### # # ####### ###
#     # #   # # #   #     #     #   # #       #   #
# # ### ##### # ######### # ##### ### ####### ### #
# #           #           #           #           E
################################################### 