###################################################
S   #                 #       #                 # #
### ########### ##### # ##### ########### ##### # #
# #   #         #   #   #   #           #   #   # #
# ### # ########### ####### ########### # # ### # #
# #   #   #                       #     # #   #   #
# # ##### # ##### ############### # ##### ### #####
# #   #   #   #   #             # #     #   #     #
# ### # ### # ### #             # ##### ### ##### #
#   #   # # #   # #             #   #   #   #     #
### ##### # ### ###             # ### ### ### #####
#     #   # # #   #             # #   #   # #     #
# ### # ### # ### #             ### ### ### ##### #
#   #   #   #   # #             #   #         #   #
# # ### # ##### # ############### ########### # # #
# # # # # #   # #   #       #   # #         # # # #
### # # # # # # ### # ### # # # # # ####### # # # #
#   #   # # #   # # #   # # # # # #   #   # # # # #
# ####### # ### # # ### # ### # # ### # ### ### # #
#           #     #     #     #       #         # E
################################################### 