###################################################################################
S #         #           #       #     #     # #         #   #   #   #   #     #   #
# # ### # ### # ####### # ##### ### # # ### # # ##### # # ### # # # # # # # # # # #
# # #   # #   # #     #   #   # #   #   #   #   #     # #     #   # # #   # # # # #
# ### ### # ### # # ####### # # # ####### ####### ##### ########### # ##### # # # #
#   # #   #   # # #         # #   #     # #     # #   #           #     #   # # # #
### # ##### ### # ### ############# ### # ### # # # # ########### ####### ### # # #
#   #       #   #   # #   #         # # #     #   # # #   #     #         # # # # #
# ########### ### ### # # # ##### ### # ############# # # # ### ########### # # # #
#             #   #   # # # #   # #     #           # # #   # #   #       #   # # #
############### ### # # # # ### # ### ##### ##### # # # ##### # # # ##### # ##### #
#     #   #     #   # # #   #   #   #     # #     #   # # #   # # # # #   # #     #
# # ### # # ##### ##### ##### # ### ##### # # ####### # # # # # ### # # ### # # ###
# #     #   #   # #   # #     #   #   #   # # #     # # #   # #     # # #   # #   #
# ########### ### # # # # # ####### # # ##### # ### # # ##### ####### # # ####### #
# #           #   # #   # # #     # # #       #   #   #   #   #       #   #       #
# # ####### ### ### ####### # ### ### ########### ####### # # ##### ######### ### #
# # # #   # #   #   # #     # #     #     #     #   #   #   #     #       #   # # #
# # # # # # # ### ### # # # # ##### ##### ##### ### # ########### # ### # # ### # #
# #   # #   #   #   #   # # #   #   #   #     #   # #       #     #   # #   #     #
# ##### ####### ### # ### ##### ### # # # ### # # # ##### # # ######### ##### #####
# #   #       #     #   #     #   #   # # #   # # #     # # #         # #     #   #
# # # ##### # ######### ### # ### ##### ### ### ####### # # ######### # ####### # #
# # #     # #   #   #   #   # # # #   #     # #     #   # #   #   #   #     #   # #
# # ##### # # # # # ##### ### # # ### ####### # ### # ### ### # ### ### ### # ### #
# # #   # # # #   #       # #   #   #   #   #     # #     # # # #   #   #   # #   #
# # # ### ### ############# ### ### # ### # # ##### ####### # # # ##### # ### # # #
#   # #   #   #           #   # #   #     #   # #   #       #   #     # #     # # #
##### # ### ########### # # # # # # ######### # # ### ##### ### ##### ##### ### ###
#   #   #       #     # # # # # # # #   #   #   #     # #   #   #   #     #   #   #
# # # ######### # ### # # # ### # ### # # # ### ####### # ### ##### ##### ##### # #
# # # #   #     # #   # #   #   #     # # # # #   #   # # #   #         #     # # #
# ### # # # # ### # ### # ### ####### # # # # ### # # # # # ### ####### ##### # # #
#   #   #   # #   #   # # #   #     # #   # #       # # # #     #   #   # #   # # #
# # ### ####### ##### # # # ### ### ####### ######### # # # ##### # # ### # ### # #
# #   # #       #     # # #   # #   #     #     #   #   # # #     # #     #   # # #
# ### # # ####### ##### ##### # ### # ### ##### # # ### # # # ##### ######### ### #
#   #   # #           #       #   #   # #       # # #   #   #   #   #   #   #   # #
### ##### ########### # ##### ### ##### ##### ### # ####### ### # ### # # # ### # #
#   #   #           # # #   #   #   # #     # #   # #     #   # #   # #   #     # #
# ##### ########### # ### # ####### # # ### # # ### # ### ##### ### # ########### #
# #       #     #   # #   #         # #   #   #   # # # #   #   # # #   #     #   #
# # ##### ### ### ### # ############# ### ####### # # # ### # ### # ### # ### # ###
#   #         #   #   #   #   #   #     #   #     #   #   #   #   #     # #   #   #
##### ####### # ### ##### # # # # ### ##### # ########### ##### # ####### # ##### #
#   # # #   # # #   #     # #   #   #       #   #       #     # #         #       #
# ### # # # ### # ##### ### ####### # ######### ### ### # # # # ####### ######### #
# #   # # #     # #     #   #   #   #   #     #     # # # # # #   #     # #     # #
# # ### # ####### # ### # ### ### # ##### ### ####### # ### # ##### ##### # ### # #
# #     # #   # #   # # # #   #   # #   #   #         #   # #       #   #   #   # #
# ##### # # # # ##### # # # ### # ### # ### ##### ### ### # ######### # # ### ### #
# #   # #   # #     #   #   #   # #   #   #   # # #     #   #     #   # #   # #   #
# # # # ##### # # ### ##### # ##### ### ##### # # ########### ### # ### ##### # ###
# # #   # #   # #       #   # #     # # #     # #   #           # # # #       #   #
# # ##### # ######### ### ### # ##### # # ##### ### # ######### # # # ### ####### #
#   #     #         # #     #         #           #         #   # # #     #   #   #
# ### ############# ### ########### ##################### ### ### # # ##### # # ###
#   #       #     #       #     #   #               #     #   # #   # # #   #   # #
### # ### ### # # ##### ### ### ##### ############# ####### ### ##### # # ####### #
#   #   #     # # #   # #   # #       #           #         #       # # #   #     #
# ##### ####### ### # ### ### ######### ### ##### ########### ### ### # ### ### # #
#     # #   #   #   #     #   #     #   #   #   # #       #   #   #   #   #     # #
##### ### # # # # ######### ### ### # ### ### ### # ##### # # # ### ##### ####### #
#   # #   #   # #   # #     #   #   # # # #       # #   # # # # #   #           # #
# # # # ########### # # ### # ### ### # # ######### # ### # # ### ### ######### # #
# # #   #         # #     # #   #       #       #   # #   # #         #   #     # #
# ##### # ####### # # ##### ### ########### ### # ### # ### ########### # # ##### #
# #     #   #   #   #   #     #       #   # # #   #   #   #   #     #   # #   #   #
# # ####### # ######### # ### # ####### # # # ####### ### # ### ### # ### ### # ###
#         # # #     #   #   # # #       # #   #     #   #   #   #   # #   #   #   #
# ######### # # # # # ##### ### # ####### ### ### # # # ##### ### ### # ### ##### #
# # #       #   # # #     # #   #       # #       #   #   #     #   # #     #   # #
# # # ####### ### ####### # # ######### # ############# ### ####### # ####### # # #
# # #       #   #         #       #   # # #   #     #   #   #   #   # # #     #   #
# # ####### ############# ######### # # # # # # ### ##### ### # # ### # # #########
#     #   # #       #   #     #     #   # # #   # #         # #   #     # #     # #
##### # ### # ##### # # ### ### ######### # ##### ########### # ######### # ### # #
#     # #   # #   #   # #   #   #     # # #     #     #       # #         # # #   #
# ##### # ### ### ##### # ### ### ### # # ##### ##### # ### ##### ######### # ### #
# #     # #   #       # # #   #   # #   #   #   #   # #   # #     #         # #   #
# ##### # # ### ##### # ### ### ### ### ### # ### # # ### ### ##### ######### # ###
#       #       #     #         #         #       #     #           #             E
###################################################################################