###############################
#S  #     #             #  #  #
#  ####  ####  ####  ####  #  #
#              #           #  #
#  ################  #######  #
#              #  #  #     #  #
#  ####  #######  #  #  #  #  #
#  #        #        #  #     #
#######  ##########  #  ####  #
#  #     #                 #  #
#  #  #  #######  ####  #  ####
#     #  #     #  #     #  #  #
#  #######  ##########  ####  #
#     #  #        #     #  #  #
#  #  #  ####  #######  #  #  #
#  #     #  #  #     #     #  #
##########  #  #  #######  #  #
#                 #  #        #
#  #  #  #######  #  #  #  ####
#  #  #     #           #    E#
############################### 