#################
#S    #   #     #
##### ### # ### #
#   #   # # # # #
# # ### # # # # #
# # # # #     # #
# # # # # ##### #
# #   # # # #   #
# ##### # # # ###
#       #   #   #
# ######### ### #
# #           # #
# ############# #
#             # #
############# # #
#              E#
################# 