##################
#S    #   #     ##
##### ### # ###  #
#   #   # # # # ##
# # ### # # # #  #
# # # #       ## #
# # # ### #####  #
# #   # #       ##
# ##### ### # ## #
#       #   #    #
# ######### ###  #
# #           #  #
# #############  #
#             #  #
############# #  #
#E               #
################## 