#####################################################################################################
S #           #   #     #           #         #   #   #             #             #   #     #       #
# ### ##### # # # # # ### ##### ### ##### ### # # # # # ######### # ##### ####### ### # # ### ### ###
#   #   #   # # # # # #   #     # #       # #   #   # #   #   #   #   #   #     #     # #       #   #
### # ### ### # ### # # ### ##### ######### ######### ##### # # ##### # # # ### ##### # ########### #
#   # #   # # #     # #   # #                         #   # #   #     # # # #   #     #       #     #
# ##### ### # ### ### ### # # ############# ########### # # ##### ##### # # # ############### # ### #
#       #   #   # #   #   # #   #   #     # #   #       #   #     # #   # # #     #         # # # # #
######### ##### ### # # ### # ### # # ### # # # # # ######### ##### # # ### ##### # ##### ### # # # #
#     #       #   # # #   # # #   #   #   #   # # # # #     #     #   # #   #   # #   #   #   # # # #
# # ### ##### ### # ##### # ### ####### ####### ### # # ### ##### # ### # ### ### # ### ### ### # # #
# #   #   # #   # #     # #   #   #   # #     #   # # # # #       # # # #   # #   # #   #   # # # # #
# ### ### # ### # ##### # ### ### ### # # ### ### # # # # ######### # # ### # # ### # ### ### # # # #
# #   #   #   # #     # # # #         # #   #   #   # #     #         #       # #   #       # # #   #
# # ### ### ### ##### # # # ########### ### ### ##### ##### ######### ######### # ######### # # # ###
# #     #     #     # # # # #   #       #   #         #   #         # #   #   # #     #   #   # # # #
# ########### # ##### # # # # # # ########### # ####### # ######### # ### # # # ##### # # ##### # # #
#       #     #   #   #   # # #   #           # #       #   #     # #     # # # #     # # #     #   #
####### # # ##### # ##### # # ####### ### ##### # ######### # # # # ####### # # # ##### # # ####### #
#   #   # # #   #   #   #   #   #   #   # # #   #     #   # # # # #       # #   # #     # #   #     #
# ### ### ### # ##### # ####### # # ### # # # ####### # # # # # ######### # ##### # ##### ### # #####
#   #   #     #       #       #   # # # # #   #     # # # # # #     #     #       # #   #   # # #   #
# # ### # ########### ####### ##### # # # # ### # ### # # # # ### # # ######### ### # # ### # # # # #
# #   # # #   #   #   #   #   #     # # # #   # #   #   # #   #   # #     #   # #   # # #   # #   # #
### ### # # # # ### ### ### ### ##### # # ##### ### ##### ##### ### ##### # # ### ### ### ### ##### #
#   #   # # # #   # #   #   #   #       #         #     #   #   # #     #   #     #   #   #   #   # #
# ### ### # # ### # ### # ### ######### ##### ######### ### # ### ##### ############# # ##### # ### #
#     #   # #   # #   #   #   #       # #   #   #         # #   #   #   #     #       # #   # #   # #
# ##### ### ### # ### # ### ### ##### ### # ##### # ####### ### ### # ##### # ### # # # # # # # # # #
#   # #   #   #     # #     #   #   #     #     # # #     #   #   #   #     #   # # # #   #   # #   #
### # ### ### ##### # ####### ### ############# # # # ### # ##### # ##### ##### ### ########### #####
#   #         #   # # #       # #     #           # # #   # #     #       #   #     #     #   #   # #
# ##### ####### # # # # ### ### # ### # ############# # ### # # ########### ####### # # ### # ### # #
#     # #   #   # # # # # #   #     #   #       #     # #   # # #   #       #       # #   # #   #   #
##### ### # # ### # # # # ### ####### ### ##### # ##### # ### ### # # # ##### ####### ### # ### ### #
#   #     #   #   # # #     #       #     #   # # #   #   # #   # # # #   #   # #   #   # #   #   # #
# ############# ##### ##### ####### ######### # # # # ##### ### # # ##### # ### # # # ### ### # ### #
# #           # #   # #   #   #     #         # #   # #       # # # #   #       # #   #   #   #     #
# # ### ##### # # # # ### # ### ##### ### ##### ##### ##### # # # # # # # ####### ##### # # #########
# #   # #     #   # #   # # #   #   # # #     #     #       # # # #   # # #           # # #       # #
# ### # # ######### # # # # # ##### # # ##### # ############# # # ##### # # ########### # ####### # #
#     # #   #     # # # # # # #   #   #   # # # #           # #   # #   # #   #   #     # #       # #
# ##### ### # ### # ### # # # # # # ### # # # # # ##### ##### ##### # ### ### # # # ##### # ####### #
# #   # #   # # # #     # # #   # # #   #   #   #   # # #   # #     # #     #   # #     # # #   #   #
# ### # ##### # # ####### # ##### # # ##### ####### # # # # # # ### # ### ####### ##### # # # # ### #
# #   #   #   # #     #   # #     #   #   #   #     # #   # # #   # #   # #       # #   # #   #   # #
# # # ### # ### # ### # # # # ### ##### # # ### ##### ##### # # ### ### # # ####### # ########### # #
#   #   #   #   # # #   # # #   # #   # # # #   #   #     #   # #   # # # #   #     # #         # # #
####### ####### # # # ##### ### ### # # # ### ### # # # ######### # # # # ### # ##### # ### # ### # #
#     #   #     # #   #   #   #     #   # #   #   # # #   #       #   # # #   # #     # #   # #   # #
# ####### ### # # # ### # ### ########### # ##### # # ### # # ####### # ### ### # ##### # ##### ### #
# #     # #   # # #   # # #   #         # #     # # #   #   #       # # #   #   #   #   #   #   #   #
# # ### # # ##### ### # # # ### ##### # # ##### # # ### ########### # # # ##### ### # ##### # ### ###
#   # #   #     # #   # #   #   #   # # #     # # # #   #   #     # # # #         # #   # # # # #   #
# ### ##### ### # ##### ##### ##### # ####### # # # # ### # ##### # ### ######### # ### # # # # # # #
# # #       #   # #     #   #   #   #   #   #   # # # #   #       #   #     #     #   #   # # #   # #
# # # ####### # # # ##### # ### # # ### # # ##### ### ### ### ####### ### # # ####### ### # # # ### #
# #   #       # #   #     #   # # #   #   #     #   #     #   #   #   #   # #   #   # #   #   # #   #
# ### # ####### ####### ####### # ### ####### # ### ####### ### # # # # # ##### # ### # ####### # ###
#   # #   #   # #       #   #   #   # #     # # #   #   #   # # #   # # # #     #   #   #     # #   #
### # ### # # ### # ##### # # ### # # # # ### # # ### # # ### # ##### # ### ####### ##### ##### ### #
# # #   #   #     #   #   # #   # # # # # #   # #   # #   #   #   #   #   #   #     #         # #   #
# # ### ############# # ### ### # # # ### # ### # # # ####### ### ####### ### ### # ####### # # # # #
# #   # #           # # # #   # # # #     # #   # #   #     #   #       #   #     #       # #   # # #
# ### # ######### ### # # ### # ### # ##### # ### ##### ### # # ####### ### ############# # ##### # #
# #   # #       #   #   #   #       # #     # #         # #   # # #       #   #       #   # #   # # #
# # ### # ##### ### ##### ########### # ##### ########### ##### # # ### ### # ### # ### ### ### # # #
# # # #   #   #     #   #   #     #   # #   #     #   #       # # #   # #   #     # #   #       # # #
# # # ##### ####### # # # # # ### ##### # # ##### # # ####### # # ### # # ####### ### ### ####### # #
#   # #     #   #   # #   # # # #       # #   #   # #   #   # # #   # # #       # #   #   #       # #
# ### # ### # # # ######### # # ######### ### # ### ### # # # # # # # ######### ### ### ### ####### #
# #     #   # #   #         # #     #     # # #     #   # #   #   # #       # #     # #   # #   #   #
# ####### ### ##### ######### # ### # ##### # ####### ### ######### ##### # # ####### ### # # # # ###
#       # #   #       #       #   # # #     #       #   #         #   # # # #   #         #   # # # #
####### # # ######### # ########### # # ####### ####### # ####### ### # # # # # ####### ####### # # #
#   #   #             # #           # # #     #         #       #       # #   #       #     #   #   #
# # # ############# ### # ##### # ### # # # ################### ######### ########### ####### ##### #
# # #         # #   #   #     # # #   #   #   #       # #     #   #   #   #   #       #     # #   # #
# ########### # # ### ######### ### ### ##### # ### # # # ### ### ### # ### ### ####### ### # # # # #
#   #     #   #     # #         #   #       # # # # # #   # #   #     # #     #   #     # #   # #   #
### # # ### ######### # # ##### # ### ####### # # # # # ### # ####### # # ### ### ##### # ##### #####
#   # #   #           # # #     #   #   #     #   # # #     #         # #   #   #       # #     #   #
# ### ### ############### # ####### ##### # ##### # # ### ######### ### ### ### ######### # ####### #
#     #   #   #           #     # # #   # # #     # # #   #   #   # #   # #   #     #     #     #   #
# ##### ### # # # ############# # # # # # ### ##### # ##### # # # ### ### ### ##### # ### ##### # # #
# #   # #   # # #         #   #   #   # # #   # #   #       # # #     # #     #   #   #   # #   # # #
# # # # # ### # ######### # # ### ##### # # ### # ########### # ####### # ####### ##### # # # ### # #
# # # #   # # # #       # # #   #   #   #       # #         # #     # #   #       #     #   #     # #
# # # ##### # # # ##### # # # ##### # ########### # ### ##### ##### # # ##### ### # ############### #
#   # #     #   # # #     # #       # #           # #   #   #       #   #   #   # #   #           # #
##### # ### ##### # # ############### ### ######### # # # # ######### ### # ### # ### # ######### # #
#   # # #   #   # # # # #           # #   #         # # # #     #   # #   #   # # #   # #   # #   # #
# # # ### # ### # # # # # ######### # # ### ######### ### ##### # # # ### ### # # # ### # # # # ### #
# # #   # #   # # #     # #   #     #   # #     #     #   #   #   # #   #   # # # # #   # #   #   # #
# # ### # ### # # # ##### # # # ######### # ##### ##### ### # ##### ### ### # # ### # ### ####### # #
# #     #   #   # # #   # # # #     #       #     #     #   # #       #     #   #   #   #       # # #
# ####### # ### # # # # # ### ##### # ####### ### # ####### # # ### ########### # # ### # ### ### # #
#       # # #   # # # #   #   #   #   #     #   # #   #     # # #   #           # #   # #   # #   # #
####### ### # ### ### ##### # # # ##### ### ### ##### # ##### # ##### ########### ##### ##### # ### #
#           #   #           #   #       #     #         #     #                 #             #     E
#####################################################################################################