#############################################################
S           #     #     #         #             #   #   #   #
########### ### # # # # # # ##### ######### ### # # # # ### #
# #       #     # # # # # #     # #       # #     #   #   # #
# # ##### ####### ### ### ##### # # ##### # ############# # #
#   #   #     #   #   #   # #   #   # #   #   #       #   # #
# ##### # ##### ### ### ### # ####### # ##### # ##### # ### #
# #     #   #   #   #       # #       # #     #   # #   #   #
# # ### ### # ### ### ####### # ### # # ### ##### # ##### # #
#   #     # # #       #   #   # #   # #     #   #   #     # #
######### # # ### ##### # # ### # ### ####### ##### ####### #
#     #   # #   # #   # #   #   # # #         #   #       # #
# ### ##### ### # ### # ######### # ####### ### # ####### # #
# # #       # # #     # # #       #   #   # #   #     #   # #
# # ####### # # ##### # # # # ##### # # # # # ##### ### ### #
# #   #   #   #     # # # # # #     #   #   # #   #   #   # #
# # # # # # ####### ### # # # ############### ### ### ### # #
# # # # #   #     #     #   #               #       #   #   #
# ### # ##### ### ####### ################# ####### # ##### #
#   # #   #   # #       # #             #         # #       #
# # # # ### ### ### ##### ##### ####### # ##### ### #########
# # #   #         # #           #       # #     #   #   #   #
# # ##### ######### # ######### ####### # # ##### ### # # # #
# #     # #         # #     #   #     # # #   #   #   # # # #
# ##### # # ####### # # ### ##### ### ### ##### ### ### # # #
#   # #   #   #     # # #         # #     #   #     # # # # #
### # ####### ####### # ########### ##### # # ####### # ### #
#   #       #         # #   # #         # # #         #     #
# ### ##### ########### # # # # ##### ### # ##### ### ##### #
#   # #   # #       # #   # # #     #     #   #   #   #   # #
### # # # # # ### # # ##### # ##### ######### # ### ### ### #
#   # # # #     # #       # #   #   #   #     #   #   #   # #
# ##### # # ##### ### ##### # # # ### ### ####### ### ### # #
#       # # #     # # #     # # # # #   # #   #   #   #   # #
######### # # ##### # # ##### ### # # # # ### # ##### # # # #
#     #   # # #   #   # #     #   #   # #   # #     # # # # #
# ### # ##### # ### ### # # ### ####### ### # ##### # # ### #
#   # #       #   #   # # # #       #   #   #     # #   #   #
# # # ########### ### # # ### ##### # # # ####### # ### # ###
# # # #     #     #   # #     #   #   # # #       # # # # # #
# # ### # ### # ### ### ####### # ##### # # ##### # # # # # #
# # #   #   # #   # #   #   #   # #     #   # #   # #   # # #
### # ##### # ### # # ### # # ### ##### ##### # ### ##### # #
#   # #   #   # # # #     #   # #     # #     #   #       # #
# ### # ####### # # ########### ##### ### # ##### ######### #
# #   #         # #     #   #       # #   #     #     #   # #
# # ### # ####### ##### # # ### ### # # ####### ##### # # # #
#   #   # #   #       #   #     # # #   #           #   # # #
# ####### # # # ##### ########### # ##### ### ########### # #
#       #   # # #   # #         # # #   # # # #         #   #
####### ##### # # # ### ### ### # # # ### # # # ####### ### #
#   #   #     #   #   # # #   #   #   #   #   # #     #   # #
# ### ### ### ####### # # ### ####### # ### ### # ####### # #
# #   #   # #   #   #   #   #     #   #   #   # # #     #   #
# # ### ### ### # # ####### ##### # ##### # ### # # # #######
#   #   #     # # #         # #   # #   # # #   #   #       #
# ### # ### # # ### # ##### # # # # # # # ### ########### # #
# #   #   # # #   # # # #   # # # # # # #   # #           # #
# ####### # # ### ### # # ### # ### # # ### # ### ######### #
#         # #         #       #       #   #       #         E
############################################################# 