#####################################################################################################
S #                 #         #   #         #             #       #             #   #           #   #
# # ############### ##### ### ### # # ##### ########### # # ### # ##### ####### # ### ####### # ### #
#   #   #         #       #   #   # #   #             # #   # # #     #       # # #   #       #     #
##### ### ####### ######### ### ### ### ############# ##### # # ##### # ##### # # # ### ##### ##### #
#     #       #     # #   #   # #     #   #     #     #   #   # # #   # #   # # # # #   # #   #   # #
# ##### ####### ### # # # ### # # ####### ### # # ##### # ### # # # ### ### # # # # # ### # ### # # #
#         #   #   #   # #   # # #   #   #   # # #       #   # # # # #       # # # # #   #     # # # #
##### ##### # ### # ### ### # # # ### # ### # # ########### ### # # ######### # # # ### ### ### # # #
#   # #     #     # #   # #   #   #   #     # #           #     #   #   #     # #   # #   # #   # # #
# # ### ########### # ### ######### ######### ######### # ####### ### # # ##### ### # ### ### ### # #
# #     #     #     # #   #     #   #     #   #       # #     #   #   #   #   #   #   # #     #   # #
# ##### # ### ####### # # ### # # ### ### # ##### # ### ####### ### ####### ##### ### # ####### ### #
# #     #   #       #   #     #   #     # #       # #   #   #   #   # #         # #         # # # # #
# ######### ####### ############### ##### ######### # ### # # ### ### # ##### # # ######### # # # # #
# #       #       #   # #         #   #       #   # #     # # #   #   #     # # # #   #   #   # #   #
# # ### ######### # # # # ####### ### # ##### ### # ####### # # ##### ##### # ### # # # # ##### #####
# # #   #       # # #   #     #   #   #     #     #   #   # #   #     #   # #     # # # #     #     #
# # # ### ### ### # ######### # ### ####### # ####### # ### ##### # ### # # ####### # # ##### ##### #
#   # #   #   #   #         # #           # # #   #     #     #   #     #   #       #   #   #       #
# ### # ### # # ########### # ########### # # # # # ##### ### # ############# # ### ##### # ####### #
# # #   #   # #   #       #     #       # # # # # # #     #   #       #       #   # #   # # #     # #
# # ##### ####### # ##### ####### ##### ### # # # # # ##### ######### ########### ### # # # # # # # #
# #     #   #   # # #   #         #         # # #   # #   # #       #       #     #   #   # # # # # #
# # # ##### # # # # # ############# ########### ##### # # # # ##### ####### # ##### ####### ### # # #
# # #     #   #   # #   #       #   #     #   #   # # # #   #     # #       #       #   #   #   # # #
# ####### ######### # # # ##### # ### ### # # ### # # ########### # # ########### ### # # ### ##### #
#       #     #     # # # #   # #   # #   # #     # # #   #   #   # #   #       # #   #   #   #     #
####### ##### # ####### # # # # ### # # ### ####### # # # # # # ### ### # # ### ### ####### ### #####
#   # #   #   # # #     #   # #     # #     #       #   # # #   # #   # # #   # #   #   #       #   #
# # # ### # # # # # # ####### ####### ####### ### ####### # ##### ### # ##### # # ### # # ####### ###
# # # #   # # # # # #     #   #     #       #   #       # #       #   #       #   # # #   #   #     #
# # # # ### ### # # ##### # ### # ######### ####### # ### ####### # ############### # ##### # # ### #
# #   #     #   # # #   #   #   # #       #         # #   #     # #     #       #   # #     # # #   #
# ######### # ### # # # ##### # ### ##### ######### ### # ##### # ### ### ##### # # # # ### ### # # #
#           # #   #   # # #   #   #   # #   #     # #   #     # #   # #   # #   # #   #   #     # # #
# ########### # # ##### # # ##### ### # ### # # # # # ####### # # ### # ### # # # ####### ####### # #
#     #   #   # # #     #       #   # # #   # # # # #     # # # # #   #     # # #   #   # #       # #
##### # # # ### # # ############# ### # # ### # ### ##### # # # # # ##### ### ##### # ### # ####### #
#   # # # # #   # # #             #   # # #   # #     #   #     # #     # #   #     # #   #   #   # #
# # # ### # # # ### # ########### # ### # # ### # ##### ### ##### ##### # # ### ##### # ##### # # # #
# #   #   # # #       #         # #   # #   # #     #   #   #     #   #   #     # #         # # #   #
# ##### # # # ######### ####### # ### # ##### ####### ####### ####### ########### # ######### # #####
# #     # # #   #   #     #   #     #   #     #   #   #   #   #       #     #   #   # #       # #   #
# ##### # # # ### # ####### # ######### ### # # # # ### # # ####### # ### # # # # ### # ####### # # #
#       # # # #   #       # # #   #   #     #   # # #   #   #       #     # # #   #   #   #   # # # #
######### # ### ######### # # # # # # ########### # # ####### ############# # ##### # ### # ### ### #
# #   #   #   # #       #   # # #   #         #   # # #     #     #       # #     # #   # #   #     #
# # # # ##### # ##### ####### # ##### ### ##### ### # # # # ##### # ##### # ##### ##### # # # ##### #
#   #     #   #     #       #   #   #   # #     # # # # # # #     #   # #   #       #   # # #     # #
# ######### # ##### # # # ######### ### ### ##### # # ### # # ####### # ########### # # # # ### ### #
#     #   # # #   # # # # #           #   #     # # #     # # #     #   #         #   # # #   #   # #
##### # # # # # # # # # ### ### ##### ### ##### # # ####### # ### ##### # ####### ##### # ##### # # #
#   # # #   #   # # # #     #   #   #   #     #   #       #   #   #     # #     # #     #     # #   #
# ### # # ######### # ####### ### # ### ##### ### # ########### # # ##### # ### # ########### # #####
#   # # # #   #   # #     #   #   #   #   #   #   #       #     # #       # #   #             # #   #
### # # ### # # # # ####### ### ##### ### # # # ######### # # ############# # # ############### ### #
#   # #   # # # # #         #   #   # #   # # #   #       # #         #     # # #   #         #     #
# # # ### # # # # ########### ### ### # ### ##### # ### ### ####### # ####### # # # # ####### ##### #
# # #   # # #   #     #     #   #   #   # #     # # #   #   #       #         #   # #   # #   #     #
# ### ### # ####### # # ### ### ### ##### ##### # # ##### ### ####### ################# # # # # #####
# #   #   #   #     # # # # #   #   #         #   #       # #       # #       #     #   # # # #   # #
# # ### ### ### ##### # # # # ### # ### ################### ####### ### ##### # ### # ### # # ### # #
# # # #     #   #   # # # #   #   #   # #             #           #   # #     #   #       # #   #   #
# # # ####### ##### # # # ##### # ### # # ####### ### ### # ### ##### # # ##### ########### ### ### #
# #     #   # #   #   #     #   # # # #         # # #   # # #   #     # #       #       #   #   #   #
# ##### # ### # # ######### ##### # # ########### # ### # # # ### ##### ######### ##### # ####### ###
#     # #   #   #         #       # #     #   #   #   # # # # # # #     #       # #       #       # #
### # # # # ############# ######### ##### # # # ### ### ### # # # # ##### ### ### ######### ####### #
#   # # # #         #   #         #     # # # #   #   # #   # # #   #       # #   #       # #   #   #
# ### # ####### ### # # ######### # # ### # # ### ### # # ### # ######### # # # ### ##### # # # ### #
# #   #     #   # # # #   #     #   #     # # #   #   #   # # #     #   # # # #   # #   #   # # #   #
# ######### # ### # # ### # # ############# # # ### # ##### # # # # # # # # # ### # # # ##### # # # #
# #   #   # #   #   # #   # #     #       # #   #   # #     # # # #   # # # #   #   # #       #   # #
# # # # # # ### # ### # ####### ### # ### # ##### ##### ### # ### ##### ### ### ##### ### ###########
#   #   # #     #     #       #     # #   #   #     #   # # #     #   #     #   #   # # #       #   #
# ####### ################### ####### # ##### # ### # ### # ####### ######### ### ### # ####### # # #
#     # #       #       #   # #       # #     # #   #   # #       #     #     #   #   #   #   #   # #
##### # # ####### ### # ### # # ####### ### ### # # ### # ### ### ### # # ##### ### ### # # ####### #
#   #   #   #       # #     #   #     #     #   # #   #     # #   #   # #     #   # #   #   #     # #
# # ### ### # ##### # ##### ######### ####### ### ######### # # ### ######### # # # ### ##### ### # #
# # #   # #   #   # # #     #         #   #     #       #   # #     #     #   # #       #     # #   #
# ### ### ##### # ### # ##### ### ### # # ### ##### ### # ### ####### # ### ### ######### ##### ### #
# #   #       # #     #     # #   # #   #   # #   #   # # # # #   #   #     #   #         #   # #   #
# # ##### ### # ########### ### ### ####### ### # # ### # # # # # # ############# ######### # # # ###
# #     #   # # #   #     #     #       #       # # #   #   #   # #               # #       #   # # #
# ##### ##### # # # ### # # ##### # ##### ####### ### # ### ##### ################# # ### ####### # #
#   #   #     # # #   # #   #   # #   #   #   #       # #   #   #   #   #   #       # # #   #     # #
# # # ### ### # # ### ####### # # ### # ### # ######### # ### # ### # # # # # ##### # # ### # ##### #
# # # #   # # #   #   #       # # # #   #   # #   #     #     # # #   #   # # #     #     #   #     #
# # # ### # # ##### ### ####### # # ##### ### # # ############# # ######### # # ######### ##### ### #
# # #     #   #   # #   #     # # #     # #   # #   #     #     # #         # # #       #     # #   #
# # ####### ### # # # ### # # # # ##### # # ### ### # # ### ##### # ####### # # # ##### ##### ### ###
# #       # #   #   # #   # # # #       # #   # #   # #   # #   # #     #   # #   #   #     #   #   #
# ##### ### # ####### ##### ### ##### ### ### # # ### ### # # # # ##### # ### ##### # ### ##### ### #
#     # #   #       #       #   #   # #   # #   # #   #   #   # #     # #   #   #   #   # #     #   #
##### # # ######### ### ##### # # # # # ### ##### # ### ####### ### # # ### ### # ##### # # ##### ###
# #   # # #     # #     #     # # # # #   #   #   # #   #     #     # # #   #   # #   # # #   #     #
# # ### # # ### # ####### ####### # ##### ### # ### # ### ### ####### # ##### ### # # # # ### ##### #
#     #     #           #         #           #     #       #         #           # #   #           E
#####################################################################################################