#################################################################################
S       #         #           #         #   #           #     #                 #
####### # ####### ##### ##### ##### ### # # ##### # ### # ##### ############# # #
#     #   #     #     # #   #       # #   #     # # # # #       #     #       # #
# # # ######### ##### # # ########### ######### ### # # ### ##### # # # ####### #
# # # #       #   #   # #       #             #   # # #   #     # # # #   #     #
# # # ##### # # # # ### # ### # ### # ########### # # ### ##### ### ##### # #####
# # #       #   # #   # # #   #     # #           # #   # #   #   # #     #     #
# # ### ############# # # # ######### # ########### # # # ### ### # # ###########
# # # # #     #     #   # # #   #   # # #   #       # # # #     #   #   #       #
# # # # # ### # # ####### # # # # # # # # # # ##### # # # # ####### ### # ##### #
# # #   #   # # #       # #   #   # # # # # #   #   # #   #   #       # #   #   #
# # ####### # # ### # ### ######### # # # # ##### ### ####### # ####### ### # # #
# # #     # #     # # #   #   #   # # #   # #     #   #     #   #     #   # # # #
# # # # # # ####### # # ### # # # # ####### # ##### ##### # # ### ### # # # # # #
# # # # # #   #     # #   # # # #   #   #   # #   #       # # #   #   # #   # # #
# # # # ##### # ######### # # # ##### # # ### # ########### ### ### ### ##### ###
# #   #       #   #     # # #   #     # #     #           # #   # # #   #   #   #
# ############### # ### # # # ### ##### ########### # ##### # ### # # ### ##### #
# #   #         # #   # # # # #       #   #         # #   #   #   # # #   #     #
# # # ### ##### # ### # # # ### ####### # ### ######### # ##### ### # ### # ### #
#   #   # #     #   # #   #       #     #     #       # #     #   # # #   # # # #
####### ### ### # ### ############# ##### ##### ##### # ### # # # # # # # # # # #
# #     #   #   #   # #         #   #     #   #     #     # # # # # #   # # #   #
# # ##### ### ##### # ##### ### # ### ##### # ### ######### # # # # ####### # ###
# #     # #   # #   #     #   # # #   #   # #     #   #     # # # #         #   #
# ##### # # ### # ####### ### # # ### # # # ####### # # ##### ### ############# #
#     # # #     #     #   #   # #   # # # # #       # #   # # #   #           # #
# # # # # ##### ##### # ####### ### ### # # # ####### # # # # # ### ### ####### #
# # # #   # #   #   # # #         #   # #   #   #     # # #   #       #     #   #
# # # ##### # ##### # # # # ##### ### # ####### # ####### # ############### # ###
# # #     #   #     #   # # # #     #   # #     #   #     #       #         #   #
### # ##### ### ########### # # ######### # ####### ### ######### # ### ####### #
#   # #   #   # #       #   #   #         # #     #     #   #       #   #       #
# ##### # ### # # # ### # ### ### ##### ### # ### ####### ### ########### #######
#       # #   #   # #   # #   #   # #   #   #   #         #   #       #   #     #
# ####### # ####### # ### ##### ### # # # ### ####### ### # ### ##### # ####### #
# #   # #   #       # #       #   # # # # #   #   #   # # # # # #   #   #     # #
# # # # ####### ##### # ##### ### # # # # ### # # # ### # # # # # # ##### ### # #
# # #     #     #     # #     #     # # #   # # #   #   # #   # # #   #   #   # #
# # ##### # ##### ##### # ##### ##### # ### ### ####### # ### # # ### # ### ### #
#   #   # # #   #     # # #   # #   # # # #   # #       #   # #   # #   # # #   #
##### ### # # ####### # # # # # # # # # # ### # # # ##### ### ##### ##### # ### #
#         # #     #   # #   #   # #   #   #   # # #       #   #   #       #     #
# ######### ### # # ### ######### ####### # ### ### ####### ### # # ### ####### #
#     #     #   # # # #     #     #     # # #     #   #   # #   #   #   #     # #
##### # ##### # ### # # ##### ####### # # # # ### ##### # # # ####### # # ### # #
# #   # #     # #   #   #     #       # # # #   #     # #   #   #   # # #   #   #
# # ### ### ### # ### ### ##### # ##### # # ### ##### # ####### ### # ##### #####
# # #   #   #   # #   #   #   # #   #   # #   #   # # #   #   #     #   #   #   #
# # ### # ### ### # ### ### # # ### # ### ### ### # # ### # # ##### ### # ### # #
# #     # #   #   #   # # # #   #   #   #   # #     #     # #     #   #   # # # #
# ####### ##### ####### # # ##### ######### # ############# ### ##### ##### # # #
#   #     #   #         # # #   #           #   #       #     #     #   #   # # #
# ### ### # # ########### # ### ############### # ##### # ######### ### # # # # #
# #   #   # # #       #   #             #     #     #   #   #     # #   # #   # #
# # ### ### # # # ##### # ############# # ### ####### # ### # ### # # ### ##### #
# #   #     #   #   #   #     #       #   #     #     #   # # #     #   #     # #
# ### ############# # ### ### # ### # # ######### ##### ### # ######### ####### #
#   #     #       #   #   #   #   # # # #   #     #   # #   # #       #     #   #
# ####### ##### ####### ##### ### # ### # # # ####### # # ### # ### ####### # # #
#       #     #       # #   #   # #     # #   #       # #   #   # #       #   # #
# ### ####### ### # ### # # ##### ####### ##### ### ### ### ##### ####### ##### #
#   # #     #   # #   #   #     #   # #   #     #   #   # # #       #   #   #   #
##### # # ##### ##### ######### ### # # ####### # ### ### # ### ### ### ### # ###
#   # # #     #     #     #     #   # # #     # #     #   # #   # #       # # # #
# # # # ### # ##### # ### # ##### ### # # ### ### ##### # # # ### ####### # # # #
# #   #   # #     # # #   #     # #   # #   #   #     # # #   # #       # # #   #
# ####### # ####### ### ####### # # ### ### ### ##### ### ##### # # # ### # ### #
#       # #   #   # #   #       # #   #     #   #   #     #       # # #   # #   #
# ##### # ### # # # # ### ####### # # ####### ### # ##### # ####### ### ### # ###
#     #   #   # #     #   #     # # #     #   #   #     # #   # #   #     # #   #
##### ##### # # ####### ### ### # ####### # ##### ##### # ### # # ### ##### ### #
# #   #   # # # #   #   #     # #         #     #   # #   #   # #     #     #   #
# # ##### # ### ### # ### ##### ######### ##### ### # ##### ### ####### ### # ###
# #       #   # #   #       #   #       #     # #         #       #     #   #   #
# ####### ### # # ########### # ### ### ##### # ### ############# # ##### ##### #
#       #   #   # #           #   # #   #   # #   # #           # #     #     # #
# ##### ### ##### # ####### ##### # # ### # # ### ### ### ##### # ##### ####### #
# #   #   # #     # #   #   #   #   #   # # #   # #   # #   #   #   # #     #   #
# ### ### # ### # # # # ##### # ######### # ### # # ### ### ####### # ##### # ###
#       #       # #   #       #           #     #         #               #     E
################################################################################# 